SO ./textures/blue.xpm
NO    ./textures/grey.xpm
WE  ./textures/red.xpm

    EA       ./textures/wood.xpm


F     245,120,66 





C         66,197,245


1111111111111111111111111
1111111111111111111111111
1000000000110000000000001
1011000001110000000000001
1001000000000000000000001
1111111110110000011100001
10000000001100000111011111111
11110111111111011100000010001
11110111111111011101010010001
1100000011010101110000010001
10000000000000001100000010001
100000000E0000001101010010001
1100000111010101111101111010111
11110111 1110101 101111010001
11111111 1111111 111111111111