111111111111111111
1010C1000000000101
1E1100000C00001111
1P1000000000000011
1C00C100000C000101
1C10C100000C000101
1C10C1000000000101
1C10C10000C0000101
1C10C1000000000101
1C10C1000000C00101
1C10C1000000000101
111111111111111111
