111111111111
1001C00000C1
100001110111
10C001E10C01
10C000010P01
111111111111